google.com|0-60 MPH Estimator|0-60-mph-estimator.zip
google.com|0-60 MPH Estimator|0-60-mph-estimator.zip
google.com|Convert Fahrenheit to Rankine – Temperature Converter|fahrenheit-to-rankine-converter.zip
google.com|Convert Feet to Kilometers – Length Converter|feet-to-kilometers-converter.zip
google.com|Convert Millimeters to Centimeters – Length Converter|millimeters-to-centimeters-converter.zip
google.com|Engine Horsepower Calculator|engine-horsepower-calculator.zip
google.com|Engine Horsepower Calculator|engine-horsepower-calculator.zip
google.com|Fuel Cost Calculator|fuel-cost-calculator.zip
google.com|Fuel Efficiency (MPG) Calculator|fuel-efficiency-mpg-calculator.zip
google.com|Gear Ratio Calculator|gear-ratio-calculator.zip
google.com|Gear Ratio Calculator|gear-ratio-calculator.zip
google.com|Quarter-Mile Time Estimator|quarter-mile-time-estimator.zip
google.com|Tire Size Calculator|tire-size-calculator.zip
google.com|Torque Calculator|torque-calculator.zip
google.com|Trip Time Calculator|trip-time-calculator.zip
google.com|Break-Even Point Calculator|break-even-point-calculator.zip
google.com|Churn Rate Calculator|churn-rate-calculator.zip
google.com|Cohort Retention Calculator|cohort-retention-calculator.zip
google.com|Compound Annual Growth Rate Calculator|compound-annual-growth-rate-calculator.zip
google.com|Contribution Margin Calculator|contribution-margin-calculator.zip
google.com|Convert Bytes to AttoBytes – Data Converter|bytes-to-attobytes-converter.zip
google.com|Convert Fahrenheit to Rankine – Temperature Converter|fahrenheit-to-rankine-converter.zip
google.com|Convert Feet to Kilometers – Length Converter|feet-to-kilometers-converter.zip
google.com|Convert Feet to Yards – Length Converter|feet-to-yards-converter.zip
google.com|Convert Miles to Meters – Length Converter|miles-to-meters-converter.zip
google.com|Convert Pounds to Ounces – Weight Converter|pounds-to-ounces-converter.zip
google.com|Cost of Goods Sold Calculator|cost-of-goods-sold-calculator.zip
google.com|Customer Lifetime Value Calculator|customer-lifetime-value-calculator.zip
google.com|Discounted Cash Flow Calculator|discounted-cash-flow-calculator.zip
google.com|EBIT Calculator|bit-calculator.zip
google.com|EBITDA Calculator|ebitda-calculator.zip
google.com|Gross Margin Calculator|gross-margin-calculator.zip
google.com|Inventory Turnover Calculator|inventory-turnover-calculator.zip
google.com|Markup Calculator|markup-calculator.zip
google.com|Net Margin Calculator|net-margin-calculator.zip
google.com|Operating Margin Calculator|operating-margin-calculator.zip
google.com|Payback Period Calculator|payback-period-calculator.zip
google.com|Price Elasticity Calculator|price-elasticity-calculator.zip
google.com|Revenue Growth Calculator|revenue-growth-calculator.zip
google.com|ROAS Calculator|roas-calculator.zip
google.com|ROI Calculator|roi-calculator.zip
google.com|Sales Forecast Calculator|sales-forecast-calculator.zip
google.com|Working Capital Calculator|working-capital-calculator.zip
google.com|Aggregate Weight Calculator|aggregate-weight-calculator.zip
google.com|Concrete Beam Volume Calculator|	concrete-beam-volume-calculator.zip
google.com|Concrete Column Volume Calculator|	concrete-column-volume-calculator.zip
google.com|Concrete Cylinder Volume Calculator|	concrete-cylinder-volume-calculator.zip
google.com|Concrete Footing Volume Calculator|	concrete-footing-volume-calculator.zip
google.com|Concrete Round Pier Volume Calculator|	concrete-round-pier-volume-calculator.zip
google.com|Concrete Slab Volume Calculator|	concrete-slab-volume-calculator.zip
google.com|Concrete Stairs Volume Calculator|	concrete-stairs-volume-calculator.zip
google.com|Concrete Trench Volume Calculator|	concrete-trench-volume-calculator.zip
google.com|Concrete Wall Volume Calculator|	concrete-wall-volume-calculator.zip
google.com|Convert AttoBytes to Bytes – Data Converter|	attobytes-to-bytes-converter.zip
google.com|Convert Centimeters to Millimeters – Length Converter|	centimeters-to-millimeters-converter.zip
google.com|Convert Meters to Miles – Length Converter|	meters-to-miles-converter.zip
google.com|Drywall Cost Calculator|	drywall-cost-calculator.zip
google.com|Drywall Sheets Calculator|	drywall-sheets-calculator.zip
google.com|Flooring Cost Calculator|	flooring-cost-calculator.zip
google.com|Lumber Board Feet Calculator|	lumber-board-feet-calculator.zip
google.com|Paint Coverage Calculator|	paint-coverage-calculator.zip
google.com|Painting Cost Calculator|	painting-cost-calculator.zip
google.com|Rebar Weight Calculator|	rebar-weight-calculator.zip
google.com|Roof Pitch Calculator|	roof-pitch-calculator.zip
google.com|Roofing Cost Calculator|	roofing-cost-calculator.zip
google.com|Soil Volume Calculator|	soil-volume-calculator.zip
google.com|Tile Quantity Calculator|	tile-quantity-calculator.zip
google.com|Tiling Cost Calculator|	tiling-cost-calculator.zip
google.com|Convert Degrees to Arcminutes - Angle Converter|	degrees-to-arcminutes-converter.zip
google.com|Convert Degrees to Arcseconds - Angle Converter|	degrees-to-arcseconds-converter.zip
google.com|Convert Degrees to Gradians - Angle Converter|	degrees-to-gradians-converter.zip
google.com|Convert Degrees to Mils - Angle Converter|	degrees-to-mils-converter.zip
google.com|Convert Degrees to Radians - Angle Converter|	degrees-to-radians-converter.zip
google.com|Convert Degrees to Turns - Angle Converter|	degrees-to-turns-converter.zip
google.com|Convert Gradians to Arcminutes - Angle Converter|	gradians-to-arcminutes-converter.zip
google.com|Convert Gradians to Arcseconds - Angle Converter|	gradians-to-arcseconds-converter.zip
google.com|Convert Gradians to Degrees - Angle Converter|	gradians-to-degrees-converter.zip
google.com|Convert Gradians to Mils - Angle Converter|	gradians-to-mils-converter.zip
google.com|Convert Gradians to Radians - Angle Converter|	gradians-to-radians-converter.zip
google.com|Convert Radians to Arcminutes - Angle Converter|	radians-to-arcminutes-converter.zip
google.com|Convert Radians to Arcseconds - Angle Converter|	radians-to-arcseconds-converter.zip
google.com|Convert Radians to Degrees - Angle Converter|	radians-to-degrees-converter.zip
google.com|Convert Radians to Gradians - Angle Converter|	radians-to-gradians-converter.zip
google.com|Convert Radians to Mils - Angle Converter|	radians-to-mils-converter.zip
google.com|Convert Radians to Turns - Angle Converter|	radians-to-turns-converter.zip
google.com|Convert Turns to Degrees - Angle Converter|	turns-to-degrees-converter.zip
google.com|Convert Turns to Degrees - Angle Converter|	turns-to-degrees-converter.zip
google.com|Convert Turns to Radians - Angle Converter|	turns-to-radians-converter.zip
google.com|Convert Meters to Miles – Length Converter|	meters-to-miles-converter.zip
google.com|Convert Ounces to Pounds – Weight Converter|	ounces-to-pounds-converter.zip
google.com|Convert Square Feet to Acres - Area Converter|	square-feet-to-acres-converter.zip
google.com|Convert Square Feet to Hectares - Area Converter|	square-feet-to-hectares-converter.zip
google.com|Convert Square Feet to Square Centimeters - Area Converter|	square-feet-to-square-centimeters-converter.zip
google.com|Convert Square Feet to Square Inches - Area Converter|	square-feet-to-square-inches-converter.zip
google.com|Convert Square Feet to Square Kilometers - Area Converter|	square-feet-to-square-kilometers-converter.zip
google.com|Convert Square Feet to Square Meters - Area Converter|	square-feet-to-square-meters-converter.zip
google.com|Convert Square Feet to Square Meters – Area Converter|	square-feet-to-square-meters-converter.zip
google.com|Convert Square Feet to Square Miles - Area Converter|	square-feet-to-square-miles-converter.zip
google.com|Convert Square Feet to Square Millimeters - Area Converter|	square-feet-to-square-millimeters-converter.zip
google.com|Convert Square Feet to Square Yards - Area Converter|	square-feet-to-square-yards-converter.zip
google.com|Convert Square Meters to Acres - Area Converter|	square-meters-to-acres-converter.zip
google.com|Convert Square Meters to Ares - Area Converter|	square-meters-to-ares-converter.zip
google.com|Convert Square Meters to Barns - Area Converter|	square-meters-to-barns-converter.zip
google.com|Convert Square Meters to Hectares - Area Converter|	square-meters-to-hectares-converter.zip
google.com|Convert Square Meters to Square Centimeters - Area Converter|	square-meters-to-square-centimeters-converter.zip
google.com|Convert Square Meters to Square Feet - Area Converter|	square-meters-to-square-feet-converter.zip
google.com|Convert Square Meters to Square Feet – Area Converter|	square-meters-to-square-feet-converter.zip
google.com|Convert Square Meters to Square Inches - Area Converter|	square-meters-to-square-inches-converter.zip
google.com|Convert Square Meters to Square Kilometers - Area Converter|	square-meters-to-square-kilometers-converter.zip
google.com|Convert Square Meters to Square Miles - Area Converter|	square-meters-to-square-miles-converter.zip
google.com|Convert Square Meters to Square Millimeters - Area Converter|	square-meters-to-square-millimeters-converter.zip
google.com|Convert Square Meters to Square Yards - Area Converter|	square-meters-to-square-yards-converter.zip
google.com|Convert Cups to Grams Flour – Kitchen Converter|	cups-to-grams-flour-converter.zip
google.com|Convert Cups to Grams Flour – Kitchen Converter|	cups-to-grams-flour-converter.zip
google.com|Convert Grams Flour to Cups – Kitchen Converter|	grams-to-cups-flour-converter.zip
google.com|Convert AUD to USD – Currency Converter|	aud-to-usd-converter.zip
google.com|Convert BTC to USD – Currency Converter|	btc-to-usd-converter.zip
google.com|Convert CAD to USD – Currency Converter|	cad-to-usd-converter.zip
google.com|Convert CHF to EUR – Currency Converter|	chf-to-eur-converter.zip
google.com|Convert ETH to USD – Currency Converter|	eth-to-usd-converter.zip
google.com|Convert EUR to CHF – Currency Converter|	eur-to-chf-converter.zip
google.com|Convert EUR to GBP – Currency Converter|	eur-to-gbp-converter.zip
google.com|Convert EUR to USD – Currency Converter|	eur-to-usd-converter.zip
google.com|Convert GBP to EUR – Currency Converter|	gbp-to-eur-converter.zip
google.com|Convert GBP to USD – Currency Converter|	gbp-to-usd-converter.zip
google.com|Convert INR to USD – Currency Converter|	inr-to-usd-converter.zip
google.com|Convert JPY to USD – Currency Converter|	jpy-to-usd-converter.zip
google.com|Convert USD to AUD – Currency Converter|	usd-to-aud-converter.zip
google.com|Convert USD to BTC – Currency Converter|	usd-to-btc-converter.zip
google.com|Convert USD to CAD – Currency Converter|	usd-to-cad-converter.zip
google.com|Convert USD to ETH – Currency Converter|	usd-to-eth-converter.zip
google.com|Convert USD to EUR – Currency Converter|	usd-to-eur-converter.zip
google.com|Convert USD to GBP – Currency Converter|	usd-to-gbp-converter.zip
google.com|Convert USD to INR – Currency Converter|	usd-to-inr-converter.zip
google.com|Convert USD to JPY – Currency Converter|	usd-to-jpy-converter.zip
google.com|Convert Gigabytes to Megabytes – Data Converter|	gigabytes-to-megabytes-converter.zip
google.com|Convert Gigabytes to Terabytes – Data Converter|	gigabytes-to-terabytes-converter.zip
google.com|Convert Kilobits to Kilobytes – Data Converter|	kilobits-to-kilobytes-converter.zip
google.com|Convert Kilobytes to Kilobits – Data Converter|	kilobytes-to-kilobits-converter.zip
google.com|Convert MB/s to Mbps – Bandwidth Converter|	mb-s-to-mbps-converter.zip
google.com|Convert Mbps to MB/s – Bandwidth Converter|	mbps-to-mb-s-converter.zip
google.com|Convert Megabytes to Gigabytes – Data Converter|	cmegabytes-to-gigabytes-converter.zip
google.com|Convert Terabytes to Gigabytes – Data Converter|	terabytes-to-gigabytes-converter.zip
google.com|Convert Bits to Bytes - Data Storage Converter|	bits-to-bytes-converter.zip
google.com|Convert Bits to Gibibytes - Data Storage Converter|	bits-to-gibibytes-converter.zip
google.com|Convert Bits to Gigabytes - Data Storage Converter|	bits-to-gigabytes-converter.zip
google.com|Convert Bits to Kibibytes - Data Storage Converter|	bits-to-kibibytes-converter.zip
google.com|Convert Bits to Kilobytes - Data Storage Converter|	bits-to-kilobytes-converter.zip
google.com|Convert Bits to Mebibytes - Data Storage Converter|	bits-to-mebibytes-converter.zip
google.com|Convert Bits to Megabytes - Data Storage Converter|	bits-to-megabytes-converter.zip
google.com|Convert Bits to Petabytes - Data Storage Converter|	bits-to-petabytes-converter.zip
google.com|Convert Bits to Tebibytes - Data Storage Converter|	bits-to-tebibytes-converter.zip
google.com|Convert Bits to Terabytes - Data Storage Converter|	bits-to-terabytes-converter.zip
google.com|Convert Bytes to Bits - Data Storage Converter|	bytes-to-bits-converter.zip
google.com|Convert Bytes to Gibibytes - Data Storage Converter|	bytes-to-gibibytes-converter.zip
google.com|Convert Bytes to Gigabytes - Data Storage Converter|	bytes-to-gigabytes-converter.zip
google.com|Convert Bytes to Kibibytes - Data Storage Converter|	bytes-to-kibibytes-converter.zip
google.com|Convert Bytes to Kilobytes - Data Storage Converter|	bytes-to-kilobytes-converter.zip
google.com|Convert Bytes to Mebibytes - Data Storage Converter|	bytes-to-mebibytes-converter.zip
google.com|Convert Bytes to Megabytes - Data Storage Converter|	bytes-to-megabytes-converter.zip
google.com|Convert Bytes to Petabytes - Data Storage Converter|	bytes-to-petabytes-converter.zip
google.com|Convert Bytes to Tebibytes - Data Storage Converter|	bytes-to-tebibytes-converter.zip
google.com|Convert Bytes to Terabytes - Data Storage Converter|	bytes-to-terabytes-converter.zip
google.com|Convert Bits per Second to Gigabits per Second - Data Transfer Converter|	bits-per-second-to-gigabits-per-second-converter.zip
google.com|Convert Bits per Second to Gigabytes per Second - Data Transfer Converter|	bits-per-second-to-gigabytes-per-second-converter.zip
google.com|Convert Bits per Second to Kilobits per Second - Data Transfer Converter|	bits-per-second-to-kilobits-per-second-converter.zip
google.com|Convert Bits per Second to Megabits per Second - Data Transfer Converter|	bits-per-second-to-megabits-per-second-converter.zip
google.com|Convert Bits per Second to Megabytes per Second - Data Transfer Converter|	bits-per-second-to-megabytes-per-second-converter.zip
google.com|Convert Bits per Second to Terabits per Second - Data Transfer Converter|	bits-per-second-to-terabits-per-second-converter.zip
google.com|Convert Gigabits per Second to Bits per Second - Data Transfer Converter|	gigabits-per-second-to-bits-per-second-converter.zip
google.com|Convert Gigabits per Second to Kilobits per Second - Data Transfer Converter|	gigabits-per-second-to-kilobits-per-second-converter.zip
google.com|Convert Kilobits per Second to Bits per Second - Data Transfer Converter|	kilobits-per-second-to-bits-per-second-converter.zip
google.com|Convert Kilobits per Second to Gigabits per Second - Data Transfer Converter|	kilobits-per-second-to-gigabits-per-second-converter.zip
google.com|Convert Kilobits per Second to Gigabytes per Second - Data Transfer Converter|	kilobits-per-second-to-gigabytes-per-second-converter.zip
google.com|Convert Kilobits per Second to Megabits per Second - Data Transfer Converter|	kilobits-per-second-to-megabits-per-second-converter.zip
google.com|Convert Kilobits per Second to Megabytes per Second - Data Transfer Converter|	kilobits-per-second-to-megabytes-per-second-converter.zip
google.com|Convert Megabits per Second to Bits per Second - Data Transfer Converter|	megabits-per-second-to-bits-per-second-converter.zip
google.com|Convert Megabits per Second to Gigabits per Second - Data Transfer Converter|	megabits-per-second-to-gigabits-per-second-converter.zip
google.com|Convert Megabits per Second to Gigabytes per Second - Data Transfer Converter|	megabits-per-second-to-gigabytes-per-second-converter.zip
google.com|Convert Megabits per Second to Kilobits per Second - Data Transfer Converter|	megabits-per-second-to-kilobits-per-second-converter.zip
google.com|Convert Megabits per Second to Megabytes per Second - Data Transfer Converter|	megabits-per-second-to-megabytes-per-second-converter.zip
google.com|Convert Megabits per Second to Terabits per Second - Data Transfer Converter|	megabits-per-second-to-terabits-per-second-converter.zip
google.com|Convert Cubic Meters to Kilograms – Density Converter|	cubic-meters-to-kilograms-converter.zip
google.com|Convert Kilograms to Cubic Meters – Density Converter|	kilograms-to-cubic-meters-converter.zip
google.com|Convert Calories to Joules – Energy Converter|	calories-to-joules-converter.zip
google.com|Convert Joules to British Thermal Units - Energy Converter|	joules-to-british-thermal-units-converter.zip
google.com|Convert Joules to Calories – Energy Converter|	joules-to-calories-converter.zip
google.com|Convert Joules to Kilojoules - Energy Converter|	joules-to-kilojoules-converter.zip
google.com|Convert Joules to Megajoules - Energy Converter|	joules-to-megajoules-converter.zip
google.com|Convert Joules to Megawatt Hours - Energy Converter|	joules-to-megawatt-hours-converter.zip
google.com|Convert Joules to Therms - Energy Converter|	joules-to-therms-converter.zip
google.com|Convert Kilocalories to Kilojoules – Energy Converter|	kilocalories-to-kilojoules-converter.zip
google.com|Convert Kilocalories to Kilojoules – Energy Converter|	kilocalories-to-kilojoules-converter.zip
google.com|Convert Kilojoules to British Thermal Units - Energy Converter|	kilojoules-to-british-thermal-units-converter.zip
google.com|Convert Kilojoules to Calories - Energy Converter|	kilojoules-to-calories-converter.zip
google.com|Convert Kilojoules to Electronvolts - Energy Converter|	kilojoules-to-electronvolts-converter.zip
google.com|Convert Kilojoules to Kilocalories – Energy Converter|	kilojoules-to-kilocalories-converter.zip
google.com|Convert Kilojoules to Kilowatt Hours - Energy Converter|	kilojoules-to-kilowatt-hours-converter.zip
google.com|Convert Kilojoules to Megajoules - Energy Converter|	kilojoules-to-megajoules-converter.zip
google.com|Convert Kilojoules to Megawatt Hours - Energy Converter|	kilojoules-to-megawatt-hours-converter.zip
google.com|Convert Kilojoules to Therms - Energy Converter|	kilojoules-to-therms-converter.zip
google.com|Convert Kilojoules to Watt Hours - Energy Converter|	kilojoules-to-watt-hours-converter.zip
google.com|Convert Gigahertz to Hertz - Frequency Converter|	gigahertz-to-hertz-converter.zip
google.com|Convert Gigahertz to Kilohertz - Frequency Converter|	gigahertz-to-kilohertz-converter.zip
google.com|Convert Hertz to Gigahertz - Frequency Converter|	hertz-to-gigahertz-converter.zip
google.com|Convert Hertz to Kilohertz - Frequency Converter|	hertz-to-kilohertz-converter.zip
google.com|Convert Hertz to Megahertz - Frequency Converter|	hertz-to-megahertz-converter.zip
google.com|Convert Hertz to Radians per Second - Frequency Converter|	hertz-to-radians-per-second-converter.zip
google.com|Convert Hertz to RPM - Frequency Converter|	hertz-to-rpm-converter.zip
google.com|Convert Hertz to Terahertz - Frequency Converter|	hertz-to-terahertz-converter.zip
google.com|Convert Kilohertz to Gigahertz - Frequency Converter|	kilohertz-to-gigahertz-converter.zip
google.com|Convert Kilohertz to Hertz - Frequency Converter|	kilohertz-to-hertz-converter.zip
google.com|Convert Kilohertz to Megahertz - Frequency Converter|	kilohertz-to-megahertz-converter.zip
google.com|Convert Kilohertz to Radians per Second - Frequency Converter|	kilohertz-to-radians-per-second-converter.zip
google.com|Convert Kilohertz to RPM - Frequency Converter|	kilohertz-to-rpm-converter.zip
google.com|Convert Megahertz to Gigahertz - Frequency Converter|	megahertz-to-gigahertz-converter.zip
google.com|Convert Megahertz to Hertz - Frequency Converter|	megahertz-to-hertz-converter.zip
google.com|Convert Megahertz to Kilohertz - Frequency Converter|	megahertz-to-kilohertz-converter.zip
google.com|Convert Megahertz to RPM - Frequency Converter|	megahertz-to-rpm-converter.zip
google.com|Convert Megahertz to Terahertz - Frequency Converter|	megahertz-to-terahertz-converter.zip
google.com|Convert Kilometers per Liter to Gallons per 100 Miles - Fuel Economy Converter|	kilometers-per-liter-to-gallons-per-100-miles-converter.zip
google.com|Convert Kilometers per Liter to Liters per 100 Kilometers - Fuel Economy Converter|	kilometers-per-liter-to-liters-per-100-kilometers-converter.zip
google.com|Convert Kilometers per Liter to Liters per Mile - Fuel Economy Converter|	kilometers-per-liter-to-liters-per-mile-converter.zip
google.com|Convert Kilometers per Liter to Miles per Gallon - Fuel Economy Converter|	kilometers-per-liter-to-miles-per-gallon-converter.zip
google.com|Convert Kilometers per Liter to Miles per Gallon UK - Fuel Economy Converter|	kilometers-per-liter-to-miles-per-gallon-uk-converter.zip
google.com|Convert Liters per 100 Kilometers to Gallons per 100 Miles - Fuel Economy Converter|	liters-per-100-kilometers-to-gallons-per-100-miles-converter.zip
google.com|Convert Liters per 100 Kilometers to Kilometers per Liter - Fuel Economy Converter|	liters-per-100-kilometers-to-kilometers-per-liter-converter.zip
google.com|Convert Liters per 100 Kilometers to Liters per Mile - Fuel Economy Converter|	liters-per-100-kilometers-to-liters-per-mile-converter.zip
google.com|Convert Liters per 100 Kilometers to Miles per Gallon - Fuel Economy Converter|	liters-per-100-kilometers-to-miles-per-gallon-converter.zip
google.com|Convert Liters per 100 Kilometers to Miles per Gallon UK - Fuel Economy Converter|	liters-per-100-kilometers-to-miles-per-gallon-uk-converter.zip
google.com|Convert Miles per Gallon to Gallons per 100 Miles - Fuel Economy Converter|	miles-per-gallon-to-gallons-per-100-miles-converter.zip
google.com|Convert Miles per Gallon to Kilometers per Liter - Fuel Economy Converter|	miles-per-gallon-to-kilometers-per-liter-converter.zip
google.com|Convert Miles per Gallon to Liters per 100 Kilometers - Fuel Economy Converter|	miles-per-gallon-to-liters-per-100-kilometers-converter.zip
google.com|Convert Miles per Gallon to Liters per Mile - Fuel Economy Converter|	miles-per-gallon-to-liters-per-mile-converter.zip
google.com|Convert Miles per Gallon to Miles per Gallon UK - Fuel Economy Converter|	miles-per-gallon-to-miles-per-gallon-uk-converter.zip
google.com|Convert Miles per Gallon UK to Gallons per 100 Miles - Fuel Economy Converter|	miles-per-gallon-uk-to-gallons-per-100-miles-converter.zip
google.com|Convert Miles per Gallon UK to Kilometers per Liter - Fuel Economy Converter|	miles-per-gallon-uk-to-kilometers-per-liter-converter.zip
google.com|Convert Miles per Gallon UK to Liters per 100 Kilometers - Fuel Economy Converter|	miles-per-gallon-uk-to-liters-per-100-kilometers-converter.zip
google.com|Convert Miles per Gallon UK to Liters per Mile - Fuel Economy Converter|	miles-per-gallon-uk-to-liters-per-mile-converter.zip
google.com|Convert Miles per Gallon UK to Miles per Gallon - Fuel Economy Converter|	miles-per-gallon-uk-to-miles-per-gallon-converter.zip
google.com|Convert Lumens to Lux – Light Converter|	lumens-to-lux-converter.zip
google.com|Convert Lux to Lumens – Light Calculator|	lux-to-lumens-calculator.zip
google.com|Convert AttoBytes to Bytes – Data Converter|	attobytes-to-bytes-converter.zip
google.com|Convert Centimeters to Feet and Inches – Length Converter|	centimeters-to-feet-and-inches-converter.zip
google.com|Convert Centimeters to Inches – Length Converter|	centimeters-to-inches-converter.zip
google.com|Convert Feet and Inches to Centimeters – Length Converter|	feet-and-inches-to-centimeters-converter.zip
google.com|Convert Feet to Inches - Length Converter|	feet-to-inches-converter.zip
google.com|Convert Feet to Kilometers - Length Converter|	feet-to-kilometers-converter.zip
google.com|Convert Feet to Meters - Length Converter|	feet-to-meters-converter.zip
google.com|Convert Feet to Meters – Length Converter|	feet-to-meters-converter.zip
google.com|Convert Feet to Yards - Length Converter|	feet-to-yards-converter.zip
google.com|Convert Inches to Centimeters – Length Converter|	inches-to-centimeters-converter.zip
google.com|Convert Kilometers to Miles – Length Converter|	kilometers-to-miles-converter.zip
google.com|Convert Kilometers to Nautical Miles – Length Converter|	kilometers-to-nautical-miles-converter.zip
google.com|Convert Meters to Angstroms - Length Converter|	meters-to-angstroms-converter.zip
google.com|Convert Meters to Astronomical Units - Length Converter|	meters-to-astronomical-units-converter.zip
google.com|Convert Meters to Centimeters - Length Converter|	meters-to-centimeters-converter.zip
google.com|Convert Meters to Chains - Length Converter|	meters-to-chains-converter.zip
google.com|Convert Meters to Chains - Length Converter|	meters-to-chains-converter.zip
google.com|Convert Meters to Fathoms - Length Converter|	meters-to-fathoms-converter.zip
google.com|Convert Meters to Feet - Length Converter|	meters-to-feet-converter.zip
google.com|Convert Meters to Feet – Length Converter|	meters-to-feet-converter.zip
google.com|Convert Meters to Furlongs - Length Converter|	meters-to-furlongs-converter.zip
google.com|Convert Meters to Inches - Length Converter|	meters-to-inches-converter.zip
google.com|Convert Meters to Kilometers - Length Converter|	meters-to-kilometers-converter.zip
google.com|Convert Meters to Light Years - Length Converter|	meters-to-light-years-converter.zip
google.com|Convert Meters to Micrometers - Length Converter|	meters-to-micrometers-converter.zip
google.com|Convert Meters to Miles – Length Converter|	meters-to-miles-converter.zip
google.com|Convert Meters to Millimeters - Length Converter|	meters-to-millimeters-converter.zip
google.com|Convert Meters to Nautical Miles - Length Converter|	meters-to-nautical-miles-converter.zip
google.com|Convert Meters to Parsecs - Length Converter|	meters-to-parsecs-converter.zip
google.com|Convert Meters to Picometers - Length Converter|	meters-to-picometers-converter.zip
google.com|Convert Meters to Yards - Length Converter|	meters-to-yards-converter.zip
google.com|Convert Miles to Kilometers – Length Converter|	miles-to-kilometers-converter.zip
google.com|Convert Nautical Miles to Kilometers – Length Converter|	nautical-miles-to-kilometers-converter.zip
google.com|Convert Rankine to Fahrenheit – Temperature Converter|	rankine-to-fahrenheit-converter.zip
google.com|Convert Yards to Feet – Length Converter|	yards-to-feet-converter.zip
google.com|Convert BTU/h to Watts – Power Converter|	btu-h-to-watts-converter.zip
google.com|Convert Horsepower to Kilowatts – Power Converter|	horsepower-to-kilowatts-converter.zip
google.com|Convert Kilowatts to BTU per Hour - Power Converter|	kilowatts-to-btu-per-hour-converter.zip
google.com|Convert Kilowatts to Foot-Pounds per Second - Power Converter|	kilowatts-to-foot-pounds-per-second-converter.zip
google.com|Convert Kilowatts to Gigawatts - Power Converter|	kilowatts-to-gigawatts-converter.zip
google.com|Convert Kilowatts to Horsepower - Power Converter|	kilowatts-to-horsepower-converter.zip
google.com|Convert Kilowatts to Horsepower – Power Converter|	kilowatts-to-horsepower-converter.zip
google.com|Convert Kilowatts to Megawatts - Power Converter|	kilowatts-to-megawatts-converter.zip
google.com|Convert Kilowatts to Metric Horsepower - Power Converter|	kilowatts-to-metric-horsepower-converter.zip
google.com|Convert Megawatts to BTU per Hour - Power Converter|	megawatts-to-btu-per-hour-converter.zip
google.com|Convert Megawatts to Gigawatts - Power Converter|	megawatts-to-gigawatts-converter.zip
google.com|Convert Megawatts to Horsepower - Power Converter|	megawatts-to-horsepower-converter.zip
google.com|Convert Megawatts to Kilowatts - Power Converter|	megawatts-to-kilowatts-converter.zip
google.com|Convert Megawatts to Watts - Power Converter|	megawatts-to-watts-converter.zip
google.com|Convert Watts to BTU per Hour - Power Converter|	watts-to-btu-per-hour-converter.zip
google.com|Convert Watts to BTU/h – Power Converter|	watts-to-btu-h-converter.zip
google.com|Convert Watts to Foot-Pounds per Second - Power Converter|	watts-to-foot-pounds-per-second-converter.zip
google.com|Convert Watts to Gigawatts - Power Converter|	watts-to-gigawatts-converter.zip
google.com|Convert Watts to Horsepower - Power Converter|	watts-to-horsepower-converter.zip
google.com|Convert Watts to Kilowatts - Power Converter|	watts-to-kilowatts-converter.zip
google.com|Convert Watts to Megawatts - Power Converter|	watts-to-megawatts-converter.zip
google.com|Convert Watts to Metric Horsepower - Power Converter|	watts-to-metric-horsepower-converter.zip
google.com|Convert Atmospheres to Bar – Pressure Converter|	atmospheres-to-bar-converter.zip
google.com|Convert Bar to Atmospheres – Pressure Converter|	bar-to-atmospheres-converter.zip
google.com|Convert Bar to PSI – Pressure Converter|	bar-to-psi-converter.zip
google.com|Convert Kilopascals to Atmospheres - Pressure Converter|	kilopascals-to-atmospheres-converter.zip
google.com|Convert Kilopascals to Bar - Pressure Converter|	kilopascals-to-bar-converter.zip
google.com|Convert Kilopascals to Inches of Mercury - Pressure Converter|	kilopascals-to-inches-of-mercury-converter.zip
google.com|Convert Kilopascals to Kilogram-Force per Square Centimeter - Pressure Converter|	kilopascals-to-kilogram-force-per-square-centimeter-converter.zip
google.com|Convert Kilopascals to Megapascals - Pressure Converter|	kilopascals-to-megapascals-converter.zip
google.com|Convert Kilopascals to Millibar - Pressure Converter|	kilopascals-to-millibar-converter.zip
google.com|Convert Kilopascals to Millimeters of Mercury - Pressure Converter|	kilopascals-to-millimeters-of-mercury-converter.zip
google.com|Convert Kilopascals to Pascals - Pressure Converter|	kilopascals-to-pascals-converter.zip
google.com|Convert Kilopascals to PSI - Pressure Converter|	kilopascals-to-psi-converter.zip
google.com|Convert Kilopascals to Torr - Pressure Converter|	kilopascals-to-torr-converter.zip
google.com|Convert kPa to PSI – Pressure Converter|	kpa-to-psi-converter.zip
google.com|Convert Pascals to Atmospheres - Pressure Converter|	pascals-to-atmospheres-converter.zip
google.com|Convert Pascals to Bar - Pressure Converter|	pascals-to-bar-converter.zip
google.com|Convert Pascals to Inches of Mercury - Pressure Converter|	pascals-to-inches-of-mercury-converter.zip
google.com|Convert Pascals to Kilogram-Force per Square Centimeter - Pressure Converter|	pascals-to-kilogram-force-per-square-centimeter-converter.zip
google.com|Convert Pascals to Kilopascals - Pressure Converter|	pascals-to-kilopascals-converter.zip
google.com|Convert Pascals to Megapascals - Pressure Converter|	pascals-to-megapascals-converter.zip
google.com|Convert Pascals to Millibar - Pressure Converter|	pascals-to-millibar-converter.zip
google.com|Convert Pascals to Millimeters of Mercury - Pressure Converter|	pascals-to-millimeters-of-mercury-converter.zip
google.com|Convert Pascals to PSI - Pressure Converter|	pascals-to-psi-converter.zip
google.com|Convert Pascals to Torr - Pressure Converter|	pascals-to-torr-converter.zip
google.com|Convert PSI to Bar – Pressure Converter|	psi-to-bar-converter.zip
google.com|Convert PSI to kPa – Pressure Converter|	psi-to-kpa-converter.zip
google.com|Convert Kilometers per Hour to Feet per Second - Speed Converter|	kilometers-per-hour-to-feet-per-second-converter.zip
google.com|Convert Kilometers per Hour to Kilometers per Second - Speed Converter|	kilometers-per-hour-to-kilometers-per-second-converter.zip
google.com|Convert Kilometers per Hour to Knots - Speed Converter|	kilometers-per-hour-to-knots-converter.zip
google.com|Convert Kilometers per Hour to Mach - Speed Converter|	kilometers-per-hour-to-mach-converter.zip
google.com|Convert Kilometers per Hour to Meters per Second - Speed Converter|	kilometers-per-hour-to-meters-per-second-converter.zip
google.com|Convert Kilometers per Hour to Miles per Hour - Speed Converter|	kilometers-per-hour-to-miles-per-hour-converter.zip
google.com|Convert Kilometers per Hour to Miles per Hour – Speed Converter|	kilometers-per-hour-to-miles-per-hour-converter.zip
google.com|Convert Kilometers per Hour to Miles per Second - Speed Converter|	kilometers-per-hour-to-miles-per-second-converter.zip
google.com|Convert Kilometers per Hour to Speed of Light - Speed Converter|	kilometers-per-hour-to-speed-of-light-converter.zip
google.com|Convert Meters per Second to Feet per Second - Speed Converter|	meters-per-second-to-feet-per-second-converter.zip
google.com|Convert Meters per Second to Kilometers per Hour - Speed Converter|	meters-per-second-to-kilometers-per-hour-converter.zip
google.com|Convert Meters per Second to Kilometers per Second - Speed Converter|	meters-per-second-to-kilometers-per-second-converter.zip
google.com|Convert Meters per Second to Knots - Speed Converter|	meters-per-second-to-knots-converter.zip
google.com|Convert Meters per Second to Mach - Speed Converter|	meters-per-second-to-mach-converter.zip
google.com|Convert Meters per Second to Miles per Hour - Speed Converter|	meters-per-second-to-miles-per-hour-converter.zip
google.com|Convert Meters per Second to Miles per Second - Speed Converter|	meters-per-second-to-miles-per-second-converter.zip
google.com|Convert Miles per Hour to Feet per Second - Speed Converter|	miles-per-hour-to-feet-per-second-converter.zip
google.com|Convert Miles per Hour to Kilometers per Hour - Speed Converter|	miles-per-hour-to-kilometers-per-hour-converter.zip
google.com|Convert Miles per Hour to Kilometers per Hour – Speed Converter|	miles-per-hour-to-kilometers-per-hour-converter.zip
google.com|Convert Miles per Hour to Knots - Speed Converter|	miles-per-hour-to-knots-converter.zip
google.com|Convert Miles per Hour to Meters per Second - Speed Converter|	miles-per-hour-to-meters-per-second-converter.zip
google.com|Convert Celsius to Fahrenheit – Temperature Converter|	celsius-to-fahrenheit-converter.zip
google.com|Convert Celsius to Kelvin – Temperature Converter|	celsius-to-kelvin-converter.zip
google.com|Convert Celsius to Rankine - Temperature Converter|	celsius-to-rankine-converter.zip
google.com|Convert Celsius to Reaumur - Temperature Converter|	celsius-to-reaumur-converter.zip
google.com|Convert Fahrenheit to Celsius - Temperature Converter|	fahrenheit-to-celsius-converter.zip
google.com|Convert Fahrenheit to Celsius – Temperature Converter|	fahrenheit-to-celsius-converter.zip
google.com|Convert Fahrenheit to Rankine – Temperature Converter|	fahrenheit-to-rankine-converter.zip
google.com|Convert Feet to Kilometers – Length Converter|	feet-to-kilometers-converter.zip
google.com|Convert Kelvin to Celsius – Temperature Converter|	kelvin-to-celsius-converter.zip
google.com|Convert Kelvin to Fahrenheit - Temperature Converter|	kelvin-to-fahrenheit-converter.zip
google.com|Convert Kelvin to Rankine – Temperature Converter|	kelvin-to-rankine-converter.zip
google.com|Convert Kelvin to Reaumur - Temperature Converter|	kelvin-to-reaumur-converter.zip
google.com|Convert Pounds to Ounces – Weight Converter|	pounds-to-ounces-converter.zip
google.com|Convert Rankine to Celsius - Temperature Converter|	rankine-to-celsius-converter.zip
google.com|Convert Rankine to Fahrenheit - Temperature Converter|	rankine-to-fahrenheit-converter.zip
google.com|Convert Rankine to Kelvin - Temperature Converter|	rankine-to-kelvin-converter.zip
google.com|Convert Rankine to Kelvin – Temperature Converter|	rankine-to-kelvin-converter.zip
google.com|Convert Rankine to Reaumur - Temperature Converter|	rankine-to-reaumur-converter.zip
google.com|Convert Reaumur to Celsius - Temperature Converter|	reaumur-to-celsius-converter.zip
google.com|Convert Reaumur to Fahrenheit - Temperature Converter|	reaumur-to-fahrenheit-converter.zip
google.com|Convert Reaumur to Kelvin - Temperature Converter|	reaumur-to-kelvin-converter.zip
google.com|Convert Reaumur to Rankine - Temperature Converter|	reaumur-to-rankine-converter.zip
google.com|Convert Days to Weeks – Time Converter|	days-to-weeks-converter.zip
google.com|Convert Hours to Days - Time Converter|	hours-to-days-converter.zip
google.com|Convert Hours to Minutes - Time Converter|	hours-to-minutes-converter.zip
google.com|Convert Hours to Minutes – Time Converter|	hours-to-minutes-converter.zip
google.com|Convert Hours to Seconds - Time Converter|	hours-to-seconds-converter.zip
google.com|Convert Hours to Weeks - Time Converter|	hours-to-weeks-converter.zip
google.com|Convert Milliseconds to Seconds – Time Converter|	milliseconds-to-seconds-converter.zip
google.com|Convert Minutes to Centuries - Time Converter|	minutes-to-centuries-converter.zip
google.com|Convert Minutes to Days - Time Converter|	minutes-to-days-converter.zip
google.com|Convert Minutes to Decades - Time Converter|	minutes-to-decades-converter.zip
google.com|Convert Minutes to Hours - Time Converter|	minutes-to-hours-converter.zip
google.com|Convert Minutes to Hours – Time Converter|	minutes-to-hours-converter.zip
google.com|Convert Minutes to Months - Time Converter|	minutes-to-months-converter.zip
google.com|Convert Minutes to Seconds - Time Converter|	minutes-to-seconds-converter.zip
google.com|Convert Minutes to Seconds – Time Converter|	minutes-to-seconds-converter.zip
google.com|Convert Minutes to Weeks - Time Converter|	minutes-to-weeks-converter.zip
google.com|Convert Minutes to Years - Time Converter|	minutes-to-years-converter.zip
google.com|Convert Minutes to Years - Time Converter|	minutes-to-years-converter.zip
google.com|Convert Seconds to Centuries - Time Converter|	seconds-to-centuries-converter.zip
google.com|Convert Seconds to Days - Time Converter|	seconds-to-days-converter.zip
google.com|Convert Seconds to Decades - Time Converter|	seconds-to-decades-converter.zip
google.com|Convert Seconds to Hours - Time Converter|	seconds-to-hours-converter.zip
google.com|Convert Seconds to Milliseconds – Time Converter|	seconds-to-milliseconds-converter.zip
google.com|Convert Seconds to Minutes - Time Converter|	seconds-to-minutes-converter.zip
google.com|Convert Seconds to Minutes – Time Converter|	seconds-to-minutes-converter.zip
google.com|Convert Seconds to Months - Time Converter|	seconds-to-months-converter.zip
google.com|Convert Seconds to Weeks - Time Converter|	seconds-to-weeks-converter.zip
google.com|Convert Seconds to Years - Time Converter|	seconds-to-years-converter.zip
google.com|Convert Teaspoons to Milliliters – Kitchen Converter|	teaspoons-to-milliliters-converter.zip
google.com|Convert Weeks to Days – Time Converter|	weeks-to-days-converter.zip
google.com|Convert Foot-pounds to Newton-meters – Torque Converter|	foot-pounds-to-newton-meters-converter.zip
google.com|Convert Newton-meters to Foot-pounds – Torque Converter|	newton-meters-to-foot-pounds-converter.zip
google.com|Convert AttoBytes to Bytes – Data Converter|	attobytes-to-bytes-converter.zip
google.com|Convert Cubic Meters to Liters – Volume Converter|	cubic-meters-to-liters-converter.zip
google.com|Convert Cups to Milliliters – Volume Converter|	cups-to-milliliters-converter.zip
google.com|Convert Gallons to Liters – Volume Converter|	gallons-to-liters-converter.zip
google.com|Convert Kilometers to Feet – Length Converter|	kilometers-to-feet-converter.zip
google.com|Convert Liters to Barrels - Volume Converter|	liters-to-barrels-converter.zip
google.com|Convert Liters to Bushels - Volume Converter|	liters-to-bushels-converter.zip
google.com|Convert Liters to Cubic Centimeters - Volume Converter|	liters-to-cubic-centimeters-converter.zip
google.com|Convert Liters to Cubic Feet - Volume Converter|	liters-to-cubic-feet-converter.zip
google.com|Convert Liters to Cubic Inches - Volume Converter|	liters-to-cubic-inches-converter.zip
google.com|Convert Liters to Cubic Meters - Volume Converter|	liters-to-cubic-meters-converter.zip
google.com|Convert Liters to Cubic Meters – Volume Converter|	liters-to-cubic-meters-converter.zip
google.com|Convert Liters to Cubic Yards - Volume Converter|	liters-to-cubic-yards-converter.zip
google.com|Convert Liters to Cups - Volume Converter|	liters-to-cups-converter.zip
google.com|Convert Liters to Drams - Volume Converter|	liters-to-drams-converter.zip
google.com|Convert Liters to Fluid Ounces - Volume Converter|	liters-to-fluid-ounces-converter.zip
google.com|Convert Liters to Gallons – Volume Converter|	liters-to-gallons-converter.zip
google.com|Convert Liters to Milliliters - Volume Converter|	liters-to-milliliters-converter.zip
google.com|Convert Liters to Pecks - Volume Converter|	liters-to-pecks-converter.zip
google.com|Convert Liters to Pints - Volume Converter|	liters-to-pints-converter.zip
google.com|Convert Liters to Quarts - Volume Converter|	liters-to-quarts-converter.zip
google.com|Convert Liters to Tablespoons - Volume Converter|	liters-to-tablespoons-converter.zip
google.com|Convert Liters to Teaspoons - Volume Converter|	liters-to-teaspoons-converter.zip
google.com|Convert Liters to UK Gallons – Volume Converter|	liters-to-uk-gallons-converter.zip
google.com|Convert Liters to US Gallons – Volume Converter|	liters-to-us-gallons-converter.zip
google.com|Convert Milliliters to Cubic Centimeters - Volume Converter|	milliliters-to-cubic-centimeters-converter.zip
google.com|Convert Milliliters to Cubic Meters - Volume Converter|	milliliters-to-cubic-meters-converter.zip
google.com|Convert Milliliters to Cups – Volume Converter|	milliliters-to-cups-converter.zip
google.com|Convert Milliliters to Liters - Volume Converter|	milliliters-to-liters-converter.zip
google.com|Convert Milliliters to Teaspoons – Kitchen Converter|	milliliters-to-teaspoons-converter.zip
google.com|Convert Milliliters to Teaspoons – Kitchen Converter|	milliliters-to-teaspoons-converter.zip
google.com|Convert Ounces to Pounds – Weight Converter|	ounces-to-pounds-converter.zip
google.com|Convert Rankine to Fahrenheit – Temperature Converter|	rankine-to-fahrenheit-converter.zip
google.com|Convert Teaspoons to Milliliters – Kitchen Converter|	teaspoons-to-milliliters-converter.zip
google.com|Convert UK Gallons to Liters – Volume Converter|	uk-gallons-to-liters-converter.zip
google.com|Convert US Gallons to Liters – Volume Converter|	us-gallons-to-liters-converter.zip
google.com|Convert Bar to Pascals – Pressure Converter|	bar-to-pascals-converter.zip
google.com|Convert Grams to Kilograms - Weight Converter|	grams-to-kilograms-converter.zip
google.com|Convert Grams to Long Tons - Weight Converter|	grams-to-long-tons-converter.zip
google.com|Convert Grams to Micrograms - Weight Converter|	grams-to-micrograms-converter.zip
google.com|Convert Grams to Milligrams - Weight Converter|	grams-to-milligrams-converter.zip
google.com|Convert Grams to Ounces – Weight Converter|	grams-to-ounces-converter.zip
google.com|Convert Grams to Pounds - Weight Converter|	grams-to-pounds-converter.zip
google.com|Convert Grams to Short Tons - Weight Converter|	grams-to-short-tons-converter.zip
google.com|Convert Grams to Tonnes - Weight Converter|	grams-to-tonnes-converter.zip
google.com|Convert Kilograms to Carats - Weight Converter|	kilograms-to-carats-converter.zip
google.com|Convert Kilograms to Grains - Weight Converter|	kilograms-to-grains-converter.zip
google.com|Convert Kilograms to Grams - Weight Converter|	kilograms-to-grams-converter.zip
google.com|Convert Kilograms to Long Tons - Weight Converter|	kilograms-to-long-tons-converter.zip
google.com|Convert Kilograms to Micrograms - Weight Converter|	kilograms-to-micrograms-converter.zip
google.com|Convert Kilograms to Milligrams - Weight Converter|	kilograms-to-milligrams-converter.zip
google.com|Convert Kilograms to Newtons - Weight Converter|	kilograms-to-newtons-converter.zip
google.com|Convert Kilograms to Ounces - Weight Converter|	kilograms-to-ounces-converter.zip
google.com|Convert Kilograms to Pounds – Weight Converter|	kilograms-to-pounds-converter.zip
google.com|Convert Kilograms to Short Tons - Weight Converter|	kilograms-to-short-tons-converter.zip
google.com|Convert Kilograms to Slugs - Weight Converter|	kilograms-to-slugs-converter.zip
google.com|Convert Kilograms to Stone – Weight Converter|	kilograms-to-stone-converter.zip
google.com|Convert Kilograms to Stones - Weight Converter|	kilograms-to-stones-converter.zip
google.com|Convert Kilograms to Tonnes - Weight Converter|	kilograms-to-tonnes-converter.zip
google.com|Convert Ounces to Grams – Weight Converter|	ounces-to-grams-converter.zip
google.com|Convert Pounds to Kilograms – Weight Converter|	pounds-to-kilograms-converter.zip
google.com|Convert Stone to Kilograms – Weight Converter|	stone-to-kilograms-converter.zip
google.com|Accrued Interest Calculator|	accrued-interest.zip
google.com|Bond Convexity Calculator|	bond-convexity.zip
google.com|Bond Duration Calculator|	bond-duration.zip
google.com|Bond Price Calculator|	bond-price.zip
google.com|Bond Yield Calculator|	bond-yield.zip
google.com|Callable Bond Calculator|	callable-bond.zip
google.com|Convertible Bond Calculator|	convertible-bond.zip
google.com|Current Yield Calculator|	current-yield.zip
google.com|Inflation Adjusted Return Calculator|	inflation-adjusted-return.zip
google.com|Macaulay Duration Calculator|	macaulay-duration.zip
google.com|Modified Duration Calculator|	modified-duration.zip
google.com|Real Yield Calculator|	real-yield.zip
google.com|Savings Bond Calculator|	savings-bond.zip
google.com|TIPS Calculator (Treasury Inflation-Protected)|	tips-calculator-treasury-inflation-protected.zip
google.com|Treasury Bill (T-Bill) Calculator|	treasury-bill-t-bill.zip
google.com|Yield to Call (YTC) Calculator|	yield-to-call-ytc.zip
google.com|Yield to Maturity (YTM) Calculator|	yield-to-maturity-ytm.zip
google.com|Zero Coupon Bond Calculator|	zero-coupon-bond.zip
google.com|CAPM Calculator (Capital Asset Pricing Model)|	capm-calculator-capital-asset-pricing-model.zip
google.com|Current Ratio Calculator|	current-ratio.zip
google.com|DCF Calculator (Discounted Cash Flow)|	dcf-calculator-discounted-cash-flow.zip
google.com|Debt Service Coverage Ratio (DSCR)|	debt-service-coverage-ratio-dscr.zip
google.com|Debt to Equity Ratio Calculator|	debt-to-equity-ratio.zip
google.com|Discounted Payback Period Calculator|	discounted-payback-period.zip
google.com|EBIT Calculator|	ebit.zip
google.com|EBITDA Calculator|	ebitda.zip
google.com|Enterprise Value Calculator|	enterprise-value.zip
google.com|Free Cash Flow Calculator|	free-cash-flow.zip
google.com|Gross Margin Calculator|	gross-margin.zip
google.com|Interest Coverage Ratio Calculator|	interest-coverage-ratio.zip
google.com|IRR Calculator (Internal Rate of Return)|	irr-calculator-internal-rate-of-return.zip
google.com|MIRR Calculator (Modified IRR)|	mirr-calculator-modified-irr.zip
google.com|Net Profit Margin Calculator|	net-profit-margin.zip
google.com|NPV Calculator (Net Present Value)|	npv-calculator-net-present-value.zip
google.com|Operating Margin Calculator|	operating-margin.zip
google.com|Payback Period Calculator|	payback-period.zip
google.com|Profitability Index Calculator|	profitability-index.zip
google.com|Quick Ratio Calculator|	quick-ratio.zip
google.com|WACC Calculator (Weighted Average Cost of Capital)|	wacc-calculator-weighted-average-cost-of-capital.zip
google.com|Working Capital Calculator|	working-capital.zip
google.com|Convert Gross Margin to Markup – Financial Converter|	gross-margin-to-markup-converter.zip
google.com|Convert Markup to Gross Margin – Financial Converter|	markup-to-gross-margin-converter.zip
google.com|Business Insurance Calculator|	business-insurance.zip
google.com|Disability Insurance Calculator|	disability-insurance.zip
google.com|Health Insurance Subsidy Calculator|	health-insurance-subsidy.zip
google.com|Homeowners Insurance Calculator|	homeowners-insurance.zip
google.com|Insurance Deductible Calculator|	insurance-deductible.zip
google.com|Insurance Premium Calculator|	insurance-premium.zip
google.com|Life Insurance Calculator|	life-insurance.zip
google.com|Long Term Care Insurance Calculator|	long-term-care-insurance.zip
google.com|Renters Insurance Calculator|	renters-insurance.zip
google.com|Term Life Insurance Calculator|	term-life-insurance.zip
google.com|Umbrella Insurance Calculator|	umbrella-insurance.zip
google.com|Whole Life Insurance Calculator|	whole-life-insurance.zip
google.com|Alpha Calculator (Investment)|	alpha-calculator-investment.zip
google.com|Asset Allocation Calculator|	asset-allocation.zip
google.com|Beta Calculator (Stock Volatility)|	beta-calculator-stock-volatility.zip
google.com|Capital Gains Tax Calculator|	capital-gains-tax.zip
google.com|Correlation Coefficient Calculator|	correlation-coefficient.zip
google.com|Cost Basis Calculator|	cost-basis.zip
google.com|Covariance Calculator|	covariance.zip
google.com|Dividend Calculator|	dividend.zip
google.com|Dividend Growth Calculator|	dividend-growth.zip
google.com|Dividend Yield Calculator|	dividend-yield.zip
google.com|Dollar Cost Averaging Calculator|	dollar-cost-averaging.zip
google.com|DRIP Calculator (Dividend Reinvestment)|	drip-calculator-dividend-reinvestment.zip
google.com|Earnings Per Share (EPS) Calculator|	earnings-per-share-eps.zip
google.com|Market Capitalization Calculator|	market-capitalization.zip
google.com|PEG Ratio Calculator|	peg-ratio.zip
google.com|Portfolio Rebalancing Calculator|	portfolio-rebalancing.zip
google.com|Portfolio Standard Deviation Calculator|	portfolio-standard-deviation.zip
google.com|Portfolio Variance Calculator|	portfolio-variance.zip
google.com|Price to Book (P/B) Ratio Calculator|	price-to-book-pb-ratio.zip
google.com|Price to Earnings (P/E) Ratio Calculator|	price-to-earnings-pe-ratio.zip
google.com|Price to Sales (P/S) Ratio Calculator|	price-to-sales-ps-ratio.zip
google.com|Reverse Stock Split Calculator|	reverse-stock-split.zip
google.com|Share Price Calculator|	share-price.zip
google.com|Sharpe Ratio Calculator|	sharpe-ratio.zip
google.com|Sortino Ratio Calculator|	sortino-ratio.zip
google.com|Stock Average Calculator|	stock-average.zip
google.com|Stock Profit Calculator|	stock-profit.zip
google.com|Stock Return Calculator|	stock-return.zip
google.com|Stock Split Calculator|	stock-split.zip
google.com|Wash Sale Calculator|	wash-sale.zip
google.com|Auto Loan Adjustable Rate Calculator|	auto-loan-adjustable-rate-calculator.zip
google.com|Auto Loan Amortization Calculator|	auto-loan-amortization-calculator.zip
google.com|Auto Loan Amortization Calculator with Bi-Weekly Payments|	auto-loan-amortization-calculator-with-bi-weekly-payments.zip
google.com|Auto Loan Amortization Calculator with Extra Payments|	auto-loan-amortization-calculator-with-extra-payments.zip
google.com|Auto Loan APR Calculator|	auto-loan-apr-calculator.zip
google.com|Auto Loan APR Calculator with Bi-Weekly Payments|	auto-loan-apr-calculator-with-bi-weekly-payments.zip
google.com|Auto Loan APR Calculator with Extra Payments|	auto-loan-apr-calculator-with-extra-payments.zip
google.com|Auto Loan Balloon Calculator|	auto-loan-balloon-calculator.zip
google.com|Auto Loan Balloon Payment Calculator|	auto-loan-balloon-payment-calculator.zip
google.com|Auto Loan Balloon Payment Calculator with Bi-Weekly Payments|	auto-loan-balloon-payment-calculator-with-bi-weekly-payments.zip
google.com|Auto Loan Extra Payments Calculator|	auto-loan-extra-payments-calculator.zip
google.com|Auto Loan Extra Payments Calculator with Bi-Weekly Payments|	auto-loan-extra-payments-calculator-with-bi-weekly-payments.zip
google.com|Auto Loan Extra Payments Calculator with Extra Payments|	auto-loan-extra-payments-calculator-with-extra-payments.zip
google.com|Auto Loan Fixed Rate Calculator|	auto-loan-fixed-rate-calculator.zip
google.com|Auto Loan Interest Calculator|	auto-loan-interest-calculator.zip
google.com|Auto Loan Interest Calculator with Bi-Weekly Payments|	auto-loan-interest-calculator-with-bi-weekly-payments.zip
google.com|Auto Loan Interest Calculator with Extra Payments|	auto-loan-interest-calculator-with-extra-payments.zip
google.com|Auto Loan Interest-Only Calculator|	auto-loan-interest-only-calculator.zip
google.com|Auto Loan Payment Adjustable Rate Estimator|	auto-loan-payment-adjustable-rate-estimator.zip
google.com|Auto Loan Payment Balloon Estimator|	auto-loan-payment-balloon-estimator.zip
google.com|Auto Loan Payment Calculator|	auto-loan-payment-calculator.zip
google.com|Auto Loan Payment Calculator with Bi-Weekly Payments|	auto-loan-payment-calculator-with-bi-weekly-payments.zip
google.com|Auto Loan Payment Calculator with Extra Payments|	auto-loan-payment-calculator-with-extra-payments.zip
google.com|Auto Loan Payment Fixed Rate Estimator|	auto-loan-payment-fixed-rate-estimator.zip
google.com|Auto Loan Payment Interest-Only Estimator|	auto-loan-payment-interest-only-estimator.zip
google.com|Auto Loan Payment Variable Rate Estimator|	auto-loan-payment-variable-rate-estimator.zip
google.com|Auto Loan Refinance Calculator|	auto-loan-refinance-calculator.zip
google.com|Auto Loan Refinance Calculator with Bi-Weekly Payments|	auto-loan-refinance-calculator-with-bi-weekly-payments.zip
google.com|Auto Loan Refinance Calculator with Extra Payments|	auto-loan-refinance-calculator-with-extra-payments.zip
google.com|Auto Loan Variable Rate Calculator|	auto-loan-variable-rate-calculator.zip
google.com|Boat Loan Amortization Calculator|	boat-loan-amortization-calculator.zip
google.com|Boat Loan Amortization Calculator with Bi-Weekly Payments|	boat-loan-amortization-calculator-with-bi-weekly-payments.zip
google.com|Boat Loan Amortization Calculator with Extra Payments|	boat-loan-amortization-calculator-with-extra-payments.zip
google.com|Boat Loan APR Calculator|	boat-loan-apr-calculator.zip
google.com|Boat Loan APR Calculator with Bi-Weekly Payments|	boat-loan-apr-calculator-with-bi-weekly-payments.zip
google.com|Boat Loan APR Calculator with Extra Payments|	boat-loan-apr-calculator-with-extra-payments.zip
google.com|Boat Loan Balloon Payment Calculator|	boat-loan-balloon-payment-calculator.zip
google.com|Boat Loan Balloon Payment Calculator with Bi-Weekly Payments|	boat-loan-balloon-payment-calculator-with-bi-weekly-payments.zip
google.com|Boat Loan Balloon Payment Calculator with Extra Payments|	boat-loan-balloon-payment-calculator-with-extra-payments.zip
google.com|Boat Loan Extra Payments Calculator|	boat-loan-extra-payments-calculator.zip
google.com|Boat Loan Extra Payments Calculator with Bi-Weekly Payments|	boat-loan-extra-payments-calculator-with-bi-weekly-payments.zip
google.com|Boat Loan Extra Payments Calculator with Extra Payments|	boat-loan-extra-payments-calculator-with-extra-payments.zip
google.com|Boat Loan Interest Calculator|	boat-loan-interest-calculator.zip
google.com|Boat Loan Interest Calculator with Bi-Weekly Payments|	boat-loan-interest-calculator-with-bi-weekly-payments.zip
google.com|Boat Loan Interest Calculator with Extra Payments|	boat-loan-interest-calculator-with-extra-payments.zip
google.com|Boat Loan Payment Calculator|	boat-loan-payment-calculator.zip
google.com|Boat Loan Payment Calculator with Bi-Weekly Payments|	boat-loan-payment-calculator-with-bi-weekly-payments.zip
google.com|Boat Loan Payment Calculator with Extra Payments|	boat-loan-payment-calculator-with-extra-payments.zip
google.com|Boat Loan Refinance Calculator|	boat-loan-refinance-calculator.zip
google.com|Boat Loan Refinance Calculator with Bi-Weekly Payments|	boat-loan-refinance-calculator-with-bi-weekly-payments.zip
google.com|Boat Loan Refinance Calculator with Extra Payments|	boat-loan-refinance-calculator-with-extra-payments.zip
google.com|Business Loan Amortization Calculator|	business-loan-amortization-calculator.zip
google.com|Business Loan Amortization Calculator with Bi-Weekly Payments|	business-loan-amortization-calculator-with-bi-weekly-payments.zip
google.com|Business Loan Amortization Calculator with Extra Payments|	business-loan-amortization-calculator-with-extra-payments.zip
google.com|Business Loan APR Calculator|	business-loan-apr-calculator.zip
google.com|Business Loan APR Calculator with Bi-Weekly Payments|	business-loan-apr-calculator-with-bi-weekly-payments.zip
google.com|Business Loan APR Calculator with Extra Payments|	business-loan-apr-calculator-with-extra-payments.zip
google.com|Business Loan Balloon Payment Calculator|	business-loan-balloon-payment-calculator.zip
google.com|Business Loan Balloon Payment Calculator with Bi-Weekly Payments|	business-loan-balloon-payment-calculator-with-bi-weekly-payments.zip
google.com|Business Loan Balloon Payment Calculator with Extra Payments|	business-loan-balloon-payment-calculator-with-extra-payments.zip
google.com|Business Loan Extra Payments Calculator|	business-loan-extra-payments-calculator.zip
google.com|Business Loan Extra Payments Calculator with Bi-Weekly Payments|	business-loan-extra-payments-calculator-with-bi-weekly-payments.zip
google.com|Business Loan Extra Payments Calculator with Extra Payments|	business-loan-extra-payments-calculator-with-extra-payments.zip
google.com|Business Loan Interest Calculator|	business-loan-interest-calculator.zip
google.com|Business Loan Interest Calculator with Bi-Weekly Payments|	business-loan-interest-calculator-with-bi-weekly-payments.zip
google.com|Business Loan Interest Calculator with Extra Payments|	business-loan-interest-calculator-with-extra-payments.zip
google.com|Business Loan Payment Calculator|	business-loan-payment-calculator.zip
google.com|Business Loan Payment Calculator with Bi-Weekly Payments|	business-loan-payment-calculator-with-bi-weekly-payments.zip
google.com|Business Loan Payment Calculator with Extra Payments|	business-loan-payment-calculator-with-extra-payments.zip
google.com|Business Loan Refinance Calculator|	business-loan-refinance-calculator.zip
google.com|Business Loan Refinance Calculator with Bi-Weekly Payments|	business-loan-refinance-calculator-with-bi-weekly-payments.zip
google.com|Business Loan Refinance Calculator with Extra Payments|	business-loan-refinance-calculator-with-extra-payments.zip
google.com|Convert Discount Rate to Final Price – Financial Converter|	discount-rate-to-final-price-converter.zip
google.com|Convert Final Price to Discount Rate – Financial Converter|	final-price-to-discount-rate-converter.zip
google.com|Convert Miles to Meters – Length Converter|	miles-to-meters-converter.zip
google.com|Home Loan Amortization Calculator|	home-loan-amortization-calculator.zip
google.com|Home Loan Amortization Calculator with Bi-Weekly Payments|	home-loan-amortization-calculator-with-bi-weekly-payments.zip
google.com|Home Loan Amortization Calculator with Extra Payments|	home-loan-amortization-calculator-with-extra-payments.zip
google.com|Home Loan APR Calculator|	home-loan-apr-calculator.zip
google.com|Home Loan APR Calculator with Bi-Weekly Payments|	home-loan-apr-calculator-with-bi-weekly-payments.zip
google.com|Home Loan APR Calculator with Extra Payments|	home-loan-apr-calculator-with-extra-payments.zip
google.com|Home Loan Balloon Payment Calculator|	home-loan-balloon-payment-calculator.zip
google.com|Home Loan Balloon Payment Calculator with Bi-Weekly Payments|	home-loan-balloon-payment-calculator-with-bi-weekly-payments.zip
google.com|Home Loan Balloon Payment Calculator with Extra Payments|	home-loan-balloon-payment-calculator-with-extra-payments.zip
google.com|Home Loan Extra Payments Calculator|	home-loan-extra-payments-calculator.zip
google.com|Home Loan Extra Payments Calculator with Bi-Weekly Payments|	home-loan-extra-payments-calculator-with-bi-weekly-payments.zip
google.com|Home Loan Extra Payments Calculator with Extra Payments|	home-loan-extra-payments-calculator-with-extra-payments.zip
google.com|Home Loan Interest Calculator|	home-loan-interest-calculator.zip
google.com|Home Loan Interest Calculator with Bi-Weekly Payments|	home-loan-interest-calculator-with-bi-weekly-payments.zip
google.com|Home Loan Interest Calculator with Extra Payments|	home-loan-interest-calculator-with-extra-payments.zip
google.com|Home Loan Payment Calculator|	home-loan-payment-calculator.zip
google.com|Home Loan Payment Calculator with Bi-Weekly Payments|	home-loan-payment-calculator-with-bi-weekly-payments.zip
google.com|Home Loan Payment Calculator with Extra Payments|	home-loan-payment-calculator-with-extra-payments.zip
google.com|Home Loan Refinance Calculator|	home-loan-refinance-calculator.zip
google.com|Home Loan Refinance Calculator with Bi-Weekly Payments|	home-loan-refinance-calculator-with-bi-weekly-payments.zip
google.com|Home Loan Refinance Calculator with Extra Payments|	home-loan-refinance-calculator-with-extra-payments.zip
google.com|Mortgage Adjustable Rate Calculator|	mortgage-adjustable-rate-calculator.zip
google.com|Mortgage Amortization Calculator|	mortgage-amortization-calculator.zip
google.com|Mortgage Amortization Calculator with Bi-Weekly Payments|	mortgage-amortization-calculator-with-bi-weekly-payments.zip
google.com|Mortgage Amortization Calculator with Extra Payments|	mortgage-amortization-calculator-with-extra-payments.zip
google.com|Mortgage APR Calculator|	mortgage-apr-calculator.zip
google.com|Mortgage APR Calculator with Bi-Weekly Payments|	mortgage-apr-calculator-with-bi-weekly-payments.zip
google.com|Mortgage APR Calculator with Extra Payments|	mortgage-apr-calculator-with-extra-payments.zip
google.com|Mortgage Balloon Calculator|	mortgage-balloon-calculator.zip
google.com|Mortgage Balloon Payment Calculator|	mortgage-balloon-payment-calculator.zip
google.com|Mortgage Balloon Payment Calculator with Bi-Weekly Payments|	mortgage-balloon-payment-calculator-with-bi-weekly-payments.zip
google.com|Mortgage Balloon Payment Calculator with Extra Payments|	mortgage-balloon-payment-calculator-with-extra-payments.zip
google.com|Mortgage Extra Payments Calculator|	mortgage-extra-payments-calculator.zip
google.com|Mortgage Extra Payments Calculator with Bi-Weekly Payments|	mortgage-extra-payments-calculator-with-bi-weekly-payments.zip
google.com|Mortgage Extra Payments Calculator with Extra Payments|	mortgage-extra-payments-calculator-with-extra-payments.zip
google.com|Mortgage Fixed Rate Calculator|	mortgage-fixed-rate-calculator.zip
google.com|Mortgage Interest Calculator|	mortgage-interest-calculator.zip
google.com|Mortgage Interest Calculator with Bi-Weekly Payments|	mortgage-interest-calculator-with-bi-weekly-payments.zip
google.com|Mortgage Interest Calculator with Extra Payments|	mortgage-interest-calculator-with-extra-payments.zip
google.com|Mortgage Interest-Only Calculator|	mortgage-interest-only-calculator.zip
google.com|Mortgage Payment Adjustable Rate Estimator|	mortgage-payment-adjustable-rate-estimator.zip
google.com|Mortgage Payment Balloon Estimator|	mortgage-payment-balloon-estimator.zip
google.com|Mortgage Payment Calculator|	mortgage-payment-calculator.zip
google.com|Mortgage Payment Calculator with Bi-Weekly Payments|	mortgage-payment-calculator-with-bi-weekly-payments.zip
google.com|Mortgage Payment Calculator with Extra Payments|	mortgage-payment-calculator-with-extra-payments.zip
google.com|Mortgage Payment Fixed Rate Estimator|	mortgage-payment-fixed-rate-estimator.zip
google.com|Mortgage Payment Interest-Only Estimator|	mortgage-payment-interest-only-estimator.zip
google.com|Mortgage Payment Variable Rate Estimator|	mortgage-payment-variable-rate-estimator.zip
google.com|Mortgage Refinance Calculator|	mortgage-refinance-calculator.zip
google.com|Mortgage Refinance Calculator with Bi-Weekly Payments|	mortgage-refinance-calculator-with-bi-weekly-payments.zip
google.com|Mortgage Refinance Calculator with Extra Payments|	mortgage-refinance-calculator-with-extra-payments.zip
google.com|Mortgage Variable Rate Calculator|	mortgage-variable-rate-calculator.zip
google.com|Motorcycle Loan Amortization Calculator|	motorcycle-loan-amortization-calculator.zip
google.com|Motorcycle Loan Amortization Calculator with Bi-Weekly Payments|	motorcycle-loan-amortization-calculator-with-bi-weekly-payments.zip
google.com|Motorcycle Loan Amortization Calculator with Extra Payments|	motorcycle-loan-amortization-calculator-with-extra-payments.zip
google.com|Motorcycle Loan APR Calculator|	motorcycle-loan-apr-calculator.zip
google.com|Motorcycle Loan APR Calculator with Bi-Weekly Payments|	motorcycle-loan-apr-calculator-with-bi-weekly-payments.zip
google.com|Motorcycle Loan APR Calculator with Extra Payments|	motorcycle-loan-apr-calculator-with-extra-payments.zip
google.com|Motorcycle Loan Balloon Payment Calculator|	motorcycle-loan-balloon-payment-calculator.zip
google.com|Motorcycle Loan Balloon Payment Calculator with Bi-Weekly Payments|	motorcycle-loan-balloon-payment-calculator-with-bi-weekly-payments.zip
google.com|Motorcycle Loan Balloon Payment Calculator with Extra Payments|	motorcycle-loan-balloon-payment-calculator-with-extra-payments.zip
google.com|Motorcycle Loan Extra Payments Calculator|	motorcycle-loan-extra-payments-calculator.zip
google.com|Motorcycle Loan Extra Payments Calculator with Bi-Weekly Payments|	motorcycle-loan-extra-payments-calculator-with-bi-weekly-payments.zip
google.com|Motorcycle Loan Extra Payments Calculator with Extra Payments|	motorcycle-loan-extra-payments-calculator-with-extra-payments.zip
google.com|Motorcycle Loan Interest Calculator|	motorcycle-loan-interest-calculator.zip
google.com|Motorcycle Loan Interest Calculator with Bi-Weekly Payments|	motorcycle-loan-interest-calculator-with-bi-weekly-payments.zip
google.com|Motorcycle Loan Interest Calculator with Extra Payments|	motorcycle-loan-interest-calculator-with-extra-payments.zip
google.com|Motorcycle Loan Payment Calculator|	motorcycle-loan-payment-calculator.zip
google.com|Motorcycle Loan Payment Calculator with Bi-Weekly Payments|	motorcycle-loan-payment-calculator-with-bi-weekly-payments.zip
google.com|Motorcycle Loan Payment Calculator with Extra Payments|	motorcycle-loan-payment-calculator-with-extra-payments.zip
google.com|Motorcycle Loan Refinance Calculator|	motorcycle-loan-refinance-calculator.zip
google.com|Motorcycle Loan Refinance Calculator with Bi-Weekly Payments|	motorcycle-loan-refinance-calculator-with-bi-weekly-payments.zip
google.com|Motorcycle Loan Refinance Calculator with Extra Payments|	motorcycle-loan-refinance-calculator-with-extra-payments.zip
google.com|Personal Loan Adjustable Rate Calculator|	personal-loan-adjustable-rate-calculator.zip
google.com|Personal Loan Amortization Calculator|	personal-loan-amortization-calculator.zip
google.com|Personal Loan Amortization Calculator with Bi-Weekly Payments|	personal-loan-amortization-calculator-with-bi-weekly-payments.zip
google.com|Personal Loan Amortization Calculator with Extra Payments|	personal-loan-amortization-calculator-with-extra-payments.zip
google.com|Personal Loan APR Calculator|	personal-loan-apr-calculator.zip
google.com|Personal Loan APR Calculator with Bi-Weekly Payments|	personal-loan-apr-calculator-with-bi-weekly-payments.zip
google.com|Personal Loan APR Calculator with Extra Payments|	personal-loan-apr-calculator-with-extra-payments.zip
google.com|Personal Loan Balloon Calculator|	personal-loan-balloon-calculator.zip
google.com|Personal Loan Balloon Payment Calculator|	personal-loan-balloon-payment-calculator.zip
google.com|Personal Loan Balloon Payment Calculator with Bi-Weekly Payments|	personal-loan-balloon-payment-calculator-with-bi-weekly-payments.zip
google.com|Personal Loan Balloon Payment Calculator with Extra Payments|	personal-loan-balloon-payment-calculator-with-extra-payments.zip
google.com|Personal Loan Extra Payments Calculator|	personal-loan-extra-payments-calculator.zip
google.com|Personal Loan Extra Payments Calculator with Bi-Weekly Payments|	personal-loan-extra-payments-calculator-with-bi-weekly-payments.zip
google.com|Personal Loan Extra Payments Calculator with Extra Payments|	personal-loan-extra-payments-calculator-with-extra-payments.zip
google.com|Personal Loan Fixed Rate Calculator|	personal-loan-fixed-rate-calculator.zip
google.com|Personal Loan Interest Calculator|	personal-loan-interest-calculator.zip
google.com|Personal Loan Interest Calculator with Bi-Weekly Payments|	personal-loan-interest-calculator-with-bi-weekly-payments.zip
google.com|Personal Loan Interest Calculator with Extra Payments|	personal-loan-interest-calculator-with-extra-payments.zip
google.com|Personal Loan Interest-Only Calculator|	personal-loan-interest-only-calculator.zip
google.com|Personal Loan Payment Adjustable Rate Estimator|	personal-loan-payment-adjustable-rate-estimator.zip
google.com|Personal Loan Payment Balloon Estimator|	personal-loan-payment-balloon-estimator.zip
google.com|Personal Loan Payment Calculator|	personal-loan-payment-calculator.zip
google.com|Personal Loan Payment Calculator with Bi-Weekly Payments|	personal-loan-payment-calculator-with-bi-weekly-payments.zip
google.com|Personal Loan Payment Calculator with Extra Payments|	personal-loan-payment-calculator-with-extra-payments.zip
google.com|Personal Loan Payment Fixed Rate Estimator|	personal-loan-payment-fixed-rate-estimator.zip
google.com|Personal Loan Payment Interest-Only Estimator|	personal-loan-payment-interest-only-estimator.zip
google.com|Personal Loan Payment Variable Rate Estimator|	personal-loan-payment-variable-rate-estimator.zip
google.com|Personal Loan Refinance Calculator|	personal-loan-refinance-calculator.zip
google.com|Personal Loan Refinance Calculator with Bi-Weekly Payments|	personal-loan-refinance-calculator-with-bi-weekly-payments.zip
google.com|Personal Loan Refinance Calculator with Extra Payments|	personal-loan-refinance-calculator-with-extra-payments.zip
google.com|Personal Loan Variable Rate Calculator|	personal-loan-variable-rate-calculator.zip
google.com|RV Loan Amortization Calculator|	rv-loan-amortization-calculator.zip
google.com|RV Loan Amortization Calculator with Bi-Weekly Payments|	rv-loan-amortization-calculator-with-bi-weekly-payments.zip
google.com|RV Loan Amortization Calculator with Extra Payments|	rv-loan-amortization-calculator-with-extra-payments.zip
google.com|RV Loan APR Calculator|	rv-loan-apr-calculator.zip
google.com|RV Loan APR Calculator with Bi-Weekly Payments|	rv-loan-apr-calculator-with-bi-weekly-payments.zip
google.com|RV Loan APR Calculator with Extra Payments|	rv-loan-apr-calculator-with-extra-payments.zip
google.com|RV Loan Balloon Payment Calculator|	rv-loan-balloon-payment-calculator.zip
google.com|RV Loan Balloon Payment Calculator with Bi-Weekly Payments|	rv-loan-balloon-payment-calculator-with-bi-weekly-payments.zip
google.com|RV Loan Balloon Payment Calculator with Extra Payments|	rv-loan-balloon-payment-calculator-with-extra-payments.zip
google.com|RV Loan Extra Payments Calculator|	rv-loan-extra-payments-calculator.zip
google.com|RV Loan Extra Payments Calculator with Bi-Weekly Payments|	rv-loan-extra-payments-calculator-with-bi-weekly-payments.zip
google.com|RV Loan Extra Payments Calculator with Extra Payments|	rv-loan-extra-payments-calculator-with-extra-payments.zip
google.com|RV Loan Interest Calculator|	rv-loan-interest-calculator.zip
google.com|RV Loan Interest Calculator with Bi-Weekly Payments|	rv-loan-interest-calculator-with-bi-weekly-payments.zip
google.com|RV Loan Interest Calculator with Extra Payments|	rv-loan-interest-calculator-with-extra-payments.zip
google.com|RV Loan Payment Calculator|	rv-loan-payment-calculator.zip
google.com|RV Loan Payment Calculator with Bi-Weekly Payments|	rv-loan-payment-calculator-with-bi-weekly-payments.zip
google.com|RV Loan Payment Calculator with Extra Payments|	rv-loan-payment-calculator-with-extra-payments.zip
google.com|RV Loan Refinance Calculator|	rv-loan-refinance-calculator.zip
google.com|RV Loan Refinance Calculator with Bi-Weekly Payments|	rv-loan-refinance-calculator-with-bi-weekly-payments.zip
google.com|RV Loan Refinance Calculator with Extra Payments|	rv-loan-refinance-calculator-with-extra-payments.zip
google.com|Student Loan Adjustable Rate Calculator|	student-loan-adjustable-rate-calculator.zip
google.com|Student Loan Amortization Calculator|	student-loan-amortization-calculator.zip
google.com|Student Loan Amortization Calculator with Bi-Weekly Payments|	student-loan-amortization-calculator-with-bi-weekly-payments.zip
google.com|Student Loan Amortization Calculator with Extra Payments|	student-loan-amortization-calculator-with-extra-payments.zip
google.com|Student Loan APR Calculator|	student-loan-apr-calculator.zip
google.com|Student Loan APR Calculator with Bi-Weekly Payments|	student-loan-apr-calculator-with-bi-weekly-payments.zip
google.com|Student Loan APR Calculator with Extra Payments|	student-loan-apr-calculator-with-extra-payments.zip
google.com|Student Loan Balloon Calculator|	student-loan-balloon-calculator.zip
google.com|Student Loan Balloon Payment Calculator|	student-loan-balloon-payment-calculator.zip
google.com|Student Loan Balloon Payment Calculator with Bi-Weekly Payments|	student-loan-balloon-payment-calculator-with-bi-weekly-payments.zip
google.com|Student Loan Balloon Payment Calculator with Extra Payments|	student-loan-balloon-payment-calculator-with-extra-payments.zip
google.com|Student Loan Extra Payments Calculator|	student-loan-extra-payments-calculator.zip
google.com|Student Loan Extra Payments Calculator with Bi-Weekly Payments|	student-loan-extra-payments-calculator-with-bi-weekly-payments.zip
google.com|Student Loan Extra Payments Calculator with Extra Payments|	student-loan-extra-payments-calculator-with-extra-payments.zip
google.com|Student Loan Fixed Rate Calculator|	student-loan-fixed-rate-calculator.zip
google.com|Student Loan Interest Calculator|	student-loan-interest-calculator.zip
google.com|Student Loan Interest Calculator with Bi-Weekly Payments|	student-loan-interest-calculator-with-bi-weekly-payments.zip
google.com|Student Loan Interest Calculator with Extra Payments|	student-loan-interest-calculator-with-extra-payments.zip
google.com|Student Loan Interest-Only Calculator|	student-loan-interest-only-calculator.zip
google.com|Student Loan Payment Adjustable Rate Estimator|	student-loan-payment-adjustable-rate-estimator.zip
google.com|Student Loan Payment Balloon Estimator|	student-loan-payment-balloon-estimator.zip
google.com|Student Loan Payment Calculator|	student-loan-payment-calculator.zip
google.com|Student Loan Payment Calculator with Bi-Weekly Payments|	student-loan-payment-calculator-with-bi-weekly-payments.zip
google.com|Student Loan Payment Calculator with Extra Payments|	student-loan-payment-calculator-with-extra-payments.zip
google.com|Student Loan Payment Fixed Rate Estimator|	student-loan-payment-fixed-rate-estimator.zip
google.com|Student Loan Payment Interest-Only Estimator|	student-loan-payment-interest-only-estimator.zip
google.com|Student Loan Payment Variable Rate Estimator|	student-loan-payment-variable-rate-estimator.zip
google.com|Student Loan Refinance Calculator|	student-loan-refinance-calculator.zip
google.com|Student Loan Refinance Calculator with Bi-Weekly Payments|	student-loan-refinance-calculator-with-bi-weekly-payments.zip
google.com|Student Loan Refinance Calculator with Extra Payments|	student-loan-refinance-calculator-with-extra-payments.zip
google.com|Student Loan Variable Rate Calculator|	student-loan-variable-rate-calculator.zip
google.com|Balance Transfer Calculator|	balance-transfer.zip
google.com|Budget Calculator|	budget.zip
google.com|Convert Bytes to AttoBytes – Data Converter|	bytes-to-attobytes-converter.zip
google.com|Convert Fahrenheit to Rankine – Temperature Converter|	fahrenheit-to-rankine-converter.zip
google.com|Convert Feet to Kilometers – Length Converter|	feet-to-kilometers-converter.zip
google.com|Convert Miles to Meters – Length Converter|	miles-to-meters-converter.zip
google.com|Convert Pounds to Ounces – Weight Converter|	pounds-to-ounces-converter.zip
google.com|Convert Yards to Miles – Length Converter|	yards-to-miles-converter.zip
google.com|Cost of Living Calculator|	cost-of-living.zip
google.com|Credit Card Minimum Payment Calculator|	credit-card-minimum-payment.zip
google.com|Credit Card Payoff Calculator|	credit-card-payoff.zip
google.com|Credit Utilization Calculator|	credit-utilization.zip
google.com|Debt Avalanche Calculator|	debt-avalanche.zip
google.com|Debt Payoff Calculator|	debt-payoff.zip
google.com|Debt Snowball Calculator|	debt-snowball.zip
google.com|Emergency Fund Calculator|	emergency-fund.zip
google.com|Expense Ratio Calculator|	expense-ratio.zip
google.com|Financial Independence Calculator|	financial-independence.zip
google.com|Hourly to Salary Calculator|	hourly-to-salary.zip
google.com|Inflation Calculator|	inflation.zip
google.com|Net Worth Calculator|	net-worth.zip
google.com|Purchasing Power Calculator|	purchasing-power.zip
google.com|Salary to Hourly Calculator|	salary-to-hourly.zip
google.com|Savings Goal Calculator|	savings-goal.zip
google.com|Savings Rate Calculator|	savings-rate.zip
google.com|Take Home Pay Calculator|	take-home-pay.zip
google.com|1031 Exchange Calculator|	1031-exchange.zip
google.com|70% Rule Calculator (Real Estate)|	70-rule-calculator-real-estate.zip
google.com|After Repair Value (ARV) Calculator|	after-repair-value-arv.zip
google.com|BRRRR Calculator (Buy Rehab Rent Refinance)|	brrrr-calculator-buy-rehab-rent-refinance.zip
google.com|Cap Rate Calculator|	cap-rate.zip
google.com|Cash on Cash Return Calculator|	cash-on-cash-return.zip
google.com|Cost Segregation Calculator|	cost-segregation.zip
google.com|Debt Yield Calculator|	debt-yield.zip
google.com|Fix and Flip Calculator|	fix-and-flip.zip
google.com|Gross Rent Multiplier (GRM) Calculator|	gross-rent-multiplier-grm.zip
google.com|Loan to Cost (LTC) Ratio Calculator|	loan-to-cost-ltc-ratio.zip
google.com|Loan to Value (LTV) Ratio Calculator|	loan-to-value-ltv-ratio.zip
google.com|Maximum Allowable Offer (MAO) Calculator|	maximum-allowable-offer-mao.zip
google.com|Operating Expense Ratio (OER) Calculator|	operating-expense-ratio-oer.zip
google.com|Property Management Fee Calculator|	property-management-fee.zip
google.com|Real Estate Depreciation Calculator|	real-estate-depreciation.zip
google.com|Real Estate ROI Calculator|	real-estate-roi.zip
google.com|Rental Income Calculator|	rental-income.zip
google.com|Rental Property Calculator|	rental-property.zip
google.com|Rental Yield Calculator|	rental-yield.zip
google.com|401(k) Calculator|	401k.zip
google.com|Annuity Payout Calculator|	annuity-payout.zip
google.com|Barista FIRE Calculator|	barista-fire.zip
google.com|Catch-Up Contribution Calculator|	catch-up-contribution.zip
google.com|Coast FIRE Calculator|	coast-fire.zip
google.com|Early Retirement Calculator|	early-retirement.zip
google.com|FIRE Calculator (Financial Independence)|	fire-calculator-financial-independence.zip
google.com|Pension Calculator|	pension.zip
google.com|Pension vs Lump Sum Calculator|	pension-vs-lump-sum.zip
google.com|Required Minimum Distribution (RMD) Calculator|	required-minimum-distribution-rmd.zip
google.com|Required Minimum Distribution (RMD) Calculator|	required-minimum-distribution-rmd.zip
google.com|Retirement Age Calculator|	retirement-age.zip
google.com|Retirement Gap Calculator|	retirement-gap.zip
google.com|Retirement Healthcare Cost Calculator|	retirement-healthcare-cost.zip
google.com|Retirement Income Calculator|	retirement-income.zip
google.com|Retirement Nest Egg Calculator|	retirement-nest-egg.zip
google.com|Retirement Savings Calculator|	retirement-savings.zip
google.com|Retirement Withdrawal Calculator|	retirement-withdrawal.zip
google.com|Roth IRA Calculator|	roth-ira.zip
google.com|Roth vs Traditional IRA Comparison|	roth-vs-traditional-ira-comparison.zip
google.com|Safe Withdrawal Rate Calculator|	safe-withdrawal-rate.zip
google.com|SEP IRA Calculator|	sep-ira.zip
google.com|SIMPLE IRA Calculator|	simple-ira.zip
google.com|Social Security Benefits Calculator|	social-security-benefits.zip
google.com|Social Security Benefits Calculator|	social-security-benefits.zip
google.com|Spousal IRA Calculator|	spousal-ira.zip
google.com|Traditional IRA Calculator|	traditional-ira.zip
google.com|1099 Tax Calculator|	1099-tax.zip
google.com|Child Tax Credit Calculator|	child-tax-credit.zip
google.com|Convert Price to VAT – Financial Converter|	price-to-vat-converter.zip
google.com|Convert VAT to Price – Financial Converter|	vat-to-price-converter.zip
google.com|Earned Income Tax Credit (EITC) Calculator|	earned-income-tax-credit-eitc.zip
google.com|Effective Tax Rate Calculator|	effective-tax-rate.zip
google.com|Estate Tax Calculator|	estate-tax.zip
google.com|Estimated Tax Calculator|	estimated-tax.zip
google.com|Gift Tax Calculator|	gift-tax.zip
google.com|Income Tax Calculator|	income-tax.zip
google.com|Inheritance Tax Calculator|	inheritance-tax.zip
google.com|Marginal Tax Rate Calculator|	marginal-tax-rate.zip
google.com|Property Tax Calculator|	property-tax.zip
google.com|Sales Tax Calculator|	sales-tax.zip
google.com|Self Employment Tax Calculator|	self-employment-tax.zip
google.com|Standard vs Itemized Deduction Calculator|	standard-vs-itemized-deduction.zip
google.com|Tax Bracket Calculator|	tax-bracket.zip
google.com|Tax Refund Calculator|	tax-refund.zip
google.com|Tax Withholding Calculator|	tax-withholding.zip
google.com|W-4 Calculator|	w-4.zip
google.com|Black-Scholes Options Calculator|	black-scholes-options.zip
google.com|Butterfly Spread Calculator|	butterfly-spread.zip
google.com|Call Option Calculator|	call-option.zip
google.com|Cash Secured Put Calculator|	cash-secured-put.zip
google.com|Collar Strategy Calculator|	collar-strategy.zip
google.com|Covered Call Calculator|	covered-call.zip
google.com|Delta Calculator (Options)|	delta-calculator-options.zip
google.com|Gamma Calculator (Options)|	gamma-calculator-options.zip
google.com|Implied Volatility Calculator|	implied-volatility.zip
google.com|Iron Condor Calculator|	iron-condor.zip
google.com|Option Greeks Calculator|	option-greeks.zip
google.com|Option Profit Calculator|	option-profit.zip
google.com|Protective Put Calculator|	protective-put.zip
google.com|Put Option Calculator|	put-option.zip
google.com|Rho Calculator (Options)|	rho-calculator-options.zip
google.com|Straddle Calculator (Options)|	straddle-calculator-options.zip
google.com|Strangle Calculator (Options)|	strangle-calculator-options.zip
google.com|Synthetic Position Calculator|	synthetic-position.zip
google.com|Theta Calculator (Options)|	theta-calculator-options.zip
google.com|Vega Calculator (Options)|	vega-calculator-options.zip
google.com|Asset Based Valuation Calculator|	asset-based-valuation.zip
google.com|Book Value Calculator|	book-value.zip
google.com|Business Valuation Calculator|	business-valuation.zip
google.com|Comparable Company Analysis Calculator|	comparable-company-analysis.zip
google.com|Discounted Earnings Method Calculator|	discounted-earnings-method.zip
google.com|Earnings Multiple Valuation Calculator|	earnings-multiple-valuation.zip
google.com|Exit Multiple Method Calculator|	exit-multiple-method.zip
google.com|Goodwill Calculator|	goodwill.zip
google.com|Perpetuity Growth Model Calculator|	perpetuity-growth-model.zip
google.com|Pre-Money Post-Money Valuation Calculator|	pre-money-post-money-valuation.zip
google.com|Precedent Transaction Analysis Calculator|	precedent-transaction-analysis.zip
google.com|Revenue Multiple Valuation Calculator|	revenue-multiple-valuation.zip
google.com|SDE Calculator (Seller Discretionary Earnings)|	sde-calculator-seller-discretionary-earnings.zip
google.com|Tangible Book Value Calculator|	tangible-book-value.zip
google.com|Terminal Value Calculator|	terminal-value.zip
google.com|Convert AttoBytes to Bytes – Data Converter|	attobytes-to-bytes-converter.zip
google.com|Convert Kilometers to Feet – Length Converter|	kilometers-to-feet-converter.zip
google.com|Convert Meters to Miles – Length Converter|	meters-to-miles-converter.zip
google.com|Convert Miles to Yards – Length Converter|	miles-to-yards-converter.zip
google.com|Convert Ounces to Pounds – Weight Converter|	ounces-to-pounds-converter.zip
google.com|Convert AttoBytes to Bytes – Data Converter|	attobytes-to-bytes-converter.zip
google.com|Convert Meters to Miles – Length Converter|	meters-to-miles-converter.zip
google.com|Convert Pascals to Bar – Pressure Converter|	pascals-to-bar-converter.zip
google.com|Convert Rankine to Fahrenheit – Temperature Converter|	rankine-to-fahrenheit-converter.zip
google.com|Basal Metabolic Rate (BMR) Calculator|	basal-metabolic-rate-bmr-calculator.zip
google.com|Body Mass Index (BMI) Calculator|	body-mass-index-bmi-calculator.zip
google.com|Body Mass Index (BMI) Calculator|	body-mass-index-bmi-calculator.zip
google.com|Calorie Burn Calculator|	calorie-burn-calculator.zip
google.com|Convert Kilometers to Feet – Length Converter|	kilometers-to-feet-converter.zip
google.com|Convert Meters to Yards – Length Converter|	meters-to-yards-converter.zip
google.com|Convert Rankine to Fahrenheit – Temperature Converter|	rankine-to-fahrenheit-converter.zip
google.com|Daily Calorie Intake Calculator|	daily-calorie-intake-calculator.zip
google.com|One-Rep Max Calculator|	one-rep-max-calculator.zip
google.com|Pace Calculator|	pace-calculator.zip
google.com|Protein Intake Calculator|	protein-intake-calculator.zip
google.com|Race Time Predictor|	race-time-predictor.zip
google.com|Target Heart Rate Zones Calculator|	target-heart-rate-zones-calculator.zip
google.com|Convert Bytes to AttoBytes – Data Converter|	bytes-to-attobytes-converter.zip
google.com|Convert Fahrenheit to Rankine – Temperature Converter|	fahrenheit-to-rankine-converter.zip
google.com|Convert Feet to Kilometers – Length Converter|	feet-to-kilometers-converter.zip
google.com|Convert Grams Flour to Cups – Kitchen Converter|	grams-flour-to-cups-converter.zip
google.com|Convert Pounds to Ounces – Weight Converter|	pounds-to-ounces-converter.zip
google.com|Age Difference Calculator|	age-difference-calculator.zip
google.com|Birthday Calculator|	birthday-calculator.zip
google.com|Convert Feet to Kilometers – Length Converter|	feet-to-kilometers-converter.zip
google.com|Convert Miles to Meters – Length Converter|	miles-to-meters-converter.zip
google.com|Convert Yards to Meters – Length Converter|	yards-to-meters-converter.zip
google.com|Meeting Planner by Time Zone|	meeting-planner-by-time-zone.zip
google.com|Pomodoro Timer|	pomodoro-timer.zip
google.com|Sleep Debt Calculator|	sleep-debt-calculator.zip
google.com|Week Number Finder|	week-number-finder.zip
google.com|Work Hours & Overtime Calculator|	work-hours-overtime-calculator.zip
google.com|World Time Zone Converter|	world-time-zone-converter.zip
google.com|Convert Feet to Kilometers – Length Converter|	feet-to-kilometers-converter.zip
google.com|Convert Miles to Meters – Length Converter|	miles-to-meters-converter.zip
google.com|Convert Pounds to Ounces – Weight Converter|	pounds-to-ounces-converter.zip
